|###..........|##########
|###..........|#....|####
|###..........|#....|####
|###..........|#....|####
|###..........|#....|####
|###..........|##########
|###..........|#....|####
|###..........|#....|####
|###..........|#....|####
|###..........|#....|####
|###..........|##########
|###..........|#....|####
|###..........|#....|####
|###..........|#....|####
|###..........|#....|####
|###..........|##########
|###..........|##########
|###..........|##########
|########################
